8
-1 -1 -1 -1 -1 -1 -1 -1
-1 -1 0 3 3 3 -1 -1
-1 -1 0 -1 -1 -1 -1 -1
-1 -1 4 -1 -1 -1 -1 -1
-1 -1 5 1 2 -1 -1 -1
-1 -1 -1 -1 2 -1 -1 -1
-1 -1 8 8 0 7 -1 -1
-1 -1 -1 -1 -1 -1 -1 -1