8
-1 -1 -1 -1 -1 -1 -1 -1
-1 -1 0 2 2 0 -1 -1
-1 -1 9 2 2 1 -1 -1
-1 -1 -1 -1 -1 10 -1 -1
-1 -1 8 2 2 10 -1 -1
-1 -1 -1 -1 -1 2 -1 -1
-1 -1 6 4 4 0 -1 -1
-1 -1 -1 -1 -1 -1 -1 -1