8
-1 -1 -1 -1 -1 -1 -1 -1
-1 4 0 0 0 0 0 -1
-1 -1 -1 -1 2 2 8 -1
-1 -1 -1 5 3 3 3 -1
-1 -1 -1 -1 -1 -1 -1 -1
-1 0 0 0 0 0 0 -1
-1 0 0 0 0 0 0 -1
-1 0 7 0 0 1 4 -1