8
-1 -1 -1 -1 -1 -1 -1 -1
-1 2 1 2 2 2 -1 -1
-1 2 2 2 2 2 -1 -1
-1 3 2 3 2 8 -1 -1
-1 -1 3 -1 -1 -1 -1 -1
-1 -1 0 -1 -1 -1 -1 -1
-1 5 0 4 4 7 -1 -1
-1 -1 -1 -1 -1 -1 -1 -1